NO ./another_wall.xpm

SO ./south_wall.xpm

WE ./wall.xpm

EA ./south_wall.xpm

F 220,100,0

C 139,,228,217




        1111111111111111111111111
        1000000000110000000000001
        1011000001110000000000001
        1001000000000000000000001
111111111011000001110000000000001
100000000011000001110111111111111
11110111111111011100000010001
11110111111111011101010010001
11000001101010111000000010001
100000N000000001100000010001
10001000000000001101010010001
1100000111010101111101111000111
11110111 1110101 101111010001
11111111 1111111 111111111111